-	ー
,	、
.	。
/	・
[	「
]	」
(	（
)	）
a	あ
ba	ば
be	べ
bi	び
bo	ぼ
bu	ぶ
bya	びゃ
byo	びょ
byu	びゅ
cha	ちゃ
che	ちぇ
cho	ちょ
chu	ちゅ
da	だ
de	で
dhi	でぃ
dhu	でゅ
di	ぢ
do	ど
du	づ
dwu	どぅ
e	え
fa	ふぁ
fe	ふぇ
fi	ふぃ
fo	ふぉ
fu	ふ
ga	が
ge	げ
gi	ぎ
go	ご
gu	ぐ
gya	ぎゃ
gyo	ぎょ
gyu	ぎゅ
ha	は
he	へ
hi	ひ
ho	ほ
hya	ひゃ
hyo	ひょ
hyu	ひゅ
i	い
ja	じゃ
je	じぇ
ji	じ
jo	じょ
ju	じゅ
ka	か
ke	け
ki	き
ko	こ
ku	く
kya	きゃ
kyo	きょ
kyu	きゅ
la	ぁ
le	ぇ
li	ぃ
lo	ぉ
ltu	っ
lu	ぅ
lwa	ゎ
lya	ゃ
lyo	ょ
lyu	ゅ
ma	ま
me	め
mi	み
mo	も
mu	む
mya	みゃ
myo	みょ
myu	みゅ
na	な
ne	ね
ni	に
nn	ん
no	の
nu	ぬ
nya	にゃ
nyo	にょ
nyu	にゅ
o	お
pa	ぱ
pe	ぺ
pi	ぴ
po	ぽ
pu	ぷ
pya	ぴゃ
pyo	ぴょ
pyu	ぴゅ
ra	ら
re	れ
ri	り
ro	ろ
ru	る
rya	りゃ
ryo	りょ
ryu	りゅ
sa	さ
se	せ
sha	しゃ
she	しぇ
sho	しょ
shu	しゅ
si	し
so	そ
su	す
ta	た
te	て
thi	てぃ
ti	ち
to	と
tu	つ
twu	とぅ
u	う
va	ゔぁ
ve	ゔぇ
vi	ゔぃ
vo	ゔぉ
vu	ゔ
wa	わ
we	うぇ
wi	うぃ
wo	を
wye	ゑ
wyi	ゐ
ya	や
yo	よ
yu	ゆ
z[	『
z]	』
za	ざ
ze	ぜ
zo	ぞ
zu	ず
